██████████████████████████████████████████████████████████████████████
██████████████████████████████████████████████████████████████████████
████      ██      ██  ██          ██              ██  ██          ████
████████  ██  ██████  ██████  ██████  ██████  ██████  ██  ████████████
████  ██              ██      ██      ██  ██  ██                  ████
████  ██  ██████████████  ██████  ██  ██  ██████████  ██████  ████████
████  ██  ██      ██  ██  ██      ██                  ██  ██      ████
████  ██  ██████  ██  ██  ██  ██████████████████  ██████  ████████████
              ██          ██  ██      ██      ██                  ████
████████  ██  ██  ██████████  ██  ██████████  ██████████  ██  ██  ████
████                                  ██      ██      ██  ██  ██  ████
████████  ██████  ██████  ██████  ██████  ██  ██  ██████████  ██  ████
████          ██  ██      ██              ██              ██  ██  ████
████████████████████████████████████████████████████████  ████████████
████████████████████████████████████████████████████████  ████████████
