██████████████████████████████████████████  ██████████████████████████
██                          ██          ██  ██              ██  ██  ██
██████████████████████  ██  ██  ██  ██  ██  ██████  ██████████  ██  ██
██      ██              ██      ██  ██      ██                      ██
██  ██████  ██  ██████████  ██████████  ██  ██  ██  ██  ██████████  ██
██          ██  ██          ██  ██  ██  ██      ██  ██  ██  ██  ██  ██
██████  ██████  ██  ██████████  ██  ██████  ██  ██  ██████  ██  ██████
██  ██  ██  ██  ██  ██  ██          ██      ██  ██                  ██
██  ██████  ██████  ██  ██████████  ██  ██  ██  ██████████  ██  ██  ██
██                  ██  ██  ██          ██  ██          ██  ██  ██  ██
██████████████  ██████  ██  ██  ██  ██  ██  ██  ██  ██████  ██  ██████
██          ██  ██              ██  ██  ██  ██  ██  ██      ██      ██
██████  ██  ██████████  ██  ██  ██  ██  ██  ██  ██  ██████  ██  ██  ██
██  ██  ██  ██      ██  ██  ██  ██  ██  ██  ██  ██      ██  ██  ██  ██
██  ██████  ██  ██████  ██  ██████  ██  ██  ██████  ██████  ██  ██  ██
██          ██  ██      ██  ██      ██  ██  ██          ██  ██  ██  ██
██████████  ██  ██████████████  ██████  ██  ██████  ██████  ██████████
██  ██                          ██      ██  ██  ██      ██          ██
██  ██  ██  ██████  ██████████████  ██  ██████  ██  ██████████████  ██
██      ██  ██      ██  ██  ██  ██  ██          ██      ██      ██  ██
██████  ██████  ██  ██  ██  ██  ██  ██  ██████████  ██  ██  ██████  ██
██      ██      ██  ██              ██  ██      ██  ██          ██  ██
██  ██  ██████████████  ██  ██  ██████  ██████  ██████████████  ██████
██  ██  ██          ██  ██  ██  ██                  ██  ██  ██  ██  ██
██  ██  ██████  ██  ██  ██████  ██████  ██████  ██████  ██  ██████  ██
██  ██      ██  ██      ██      ██          ██  ██      ██          ██
██████████████████████  ██  ██  ██  ██  ██  ██████████  ██████████  ██
██  ██                  ██  ██  ██  ██  ██              ██          ██
██  ██████  ██  ██  ██  ██████████████  ██████  ██  ██  ██  ██████  ██
██          ██  ██  ██      ██              ██  ██  ██          ██  ██
██████  ██  ██  ██████  ██████████  ██████████  ██████  ██  ██████████
    ██  ██  ██      ██  ██              ██          ██  ██  ██      ██
██  ██  ██████████████  ██  ██  ██  ██  ██████  ██████  ██████  ██  ██
██      ██              ██  ██  ██  ██      ██  ██              ██  ██
██████████████████████████████████████████████████████████████████████
